########D#######
#d.......#r...d#
#.########.###.#
#r........u###.#
##############.#
#d............r#
#.##############
#r............d#
##############.#
#d............r#
#.##############
#r............d#
##############.#
#d.l#d.l#d.l##.#
#.#u.l#u.l#u..l#
#.##############
