################
R.............d#
##############.#
#d..........l#.#
#.##########.#.#
#.##########.#.#
#.##########.#.#
#.##########.#.#
#.##########u.l#
#.#r.....d######
#.#.#####.######
#.#.#####.######
#.#.#####.######
#.#.#####.######
#r.u#####.######
#########.######
