########D#######
#d......l#r...d#
#.########.###.#
#r........u###.#
##############.#
#d............l#
#.##############
#r............d#
##############.#
#d............l#
#.##############
#r............d#
##############.#
#d.l#d.l#d.l##.#
#.#u.l#u.l#u..l#
#.##############
