################
R....d#r.d#r..d#
#####.#.#.#.##.#
#d.l#r.u#.#.#dl#
#.#.#####.#.#.##
#.#u.....l#.#rd#
#.#########.##.#
#r.........u#dl#
#############.##
#d...........l##
#.##############
#r...........d##
#############.##
#d.l#d.l#d.l#.##
#.#u.l#u.l#u.l##
#.##############
